7
I0 L0 T0 I0 I0 C0 L0
C0 T0 I0 L0 C0 C0 I0
L0 T0 L0 T0 T0 T0 T0
I0 I0 L0 S0 L0 C0 T0
I0 C0 C0 T0 C0 L0 L0
T0 C0 C0 L0 C0 L0 L0
C0 C0 T0 C0 I0 I0 L0